####
#  #######
#  .     #
#  #BBBBB#
# ##.....#
#  #  B  #
## #### ##
#        #
#   ##  &#
##########
